X=40
Y=72
------------------------------------------------------------------------
|                              #~#                                     |
|                              #~#                                     |
|                              #~#                                     |
|                              #~#                                     |
|                              #~#                                     |
|                              #~#                                     |
|                              #~#                                     |
|                              #~#                                     |
|                              #~#                                     |
|                              #~#                                     |
|                              #~#                                     |
|                              #~#                                     |
|                              #~#                                     |
|                              #~#                                     |
|                              #~#                                     |
|                              #~#                                     |
|                              #~#                                     |
|                             ~#~#~                                    |
|#############################  ~  ####################################|
|~~~~~~~~~~~~~~~~~~~~~~~~~~~~~~~~~~~~~~~~~~~~~~~~~~~~~~~~~~~~~~~~~~~~~~|
|#############################  ~  ####################################|
|                             ~#~#~                                    |
|                              #~#                                     |
|                              #~#                                     |
|                              #~#                                     |
|                              #~#                                     |
|                              #~#                                     |
|                              #~#                                     |
|                              #~#                                     |
|                              #~#                                     |
|                              #~#                                     |
|                              #~#                                     |
|                              #~#                                     |
|                              #~#                                     |
|                              #~#                                     |
|                              #~#                                     |
|                              #~#                                     |
|                              #~#                                     |
------------------------------------------------------------------------
