----------------------------------------------------------------------
|	   ~~~~~~~~~~~~~~~~~~~~~~~~~~~~~~~~~~~~~~~~~~~~~~~~~~~~~~~~~~~~~~|
|  	   ~~~~~~~~~~~~~~~~~~~~~~~~~~~~~~~~~~~~~~~~~~~~~~~~~~~~~~~~~~~~~~|
|  ##~~##~~##~~##~~##~~##~~##~~######~~##~~##~~##~~##~~##~~##~~##~~~~|
|  ##~~##~~##~~##~~##~~##~~##~~######~~##~~##~~##~~##~~##~~##~~##~~~~|
|~~~~~~~~~~~~~~~~~~~~~~~~~~~~~~~~##~~~~~~~~~~~~~~~~~~~~~~~~~~~~~~~~~~|
|~~~~~~~~~~~~~~~~~~~~~~~~~~~~~~~~##~~~~~~~~~~~~~~~~~~~~~~~~~~~~~~~~~~| 
|~~##~~##~~##~~##~~##~~##~~##~~######~~##~~##~~##~~##~~##~~##~~##~~~~|
|~~##~~##~~##~~##~~##~~##~~##~~######~~##~~##~~##~~##~~##~~##~~##~~~~|
|~~~~~~~~~~~~~~~~~~~~~~~~~~~~~~~~##~~~~~~~~~~~~~~~~~~~~~~~~~~~~~~~~~~|
|~~~~~~~~~~~~~~~~~~~~~~~~~~~~~~~~##~~~~~~~~~~~~~~~~~~~~~~~~~~~~~~~~~~| 
|~~##~~##~~##~~##~~##~~##~~##~~######~~##~~##~~##~~##~~##~~##~~##~~~~|
|~~##~~##~~##~~##~~##~~##~~##~~######~~##~~##~~##~~##~~##~~##~~##~~~~|
|~~~~~~~~~~~~~~~~~~~~~~~~~~~~~~~~##~~~~~~~~~~~~~~~~~~~~~~~~~~~~~~~~~~|
|~~~~~~~~~~~~~~~~~~~~~~~~~~~~~~~~##~~~~~~~~~~~~~~~~~~~~~~~~~~~~~~~~~~| 
|~~##~~##~~##~~##~~##~~##~~##~~######~~##~~##~~##~~##~~##~~##~~##~~~~|
|~~##~~##~~##~~##~~##~~##~~##~~######~~##~~##~~##~~##~~##~~##~~##~~~~|
|~~~~~~~~~~~~~~~~~~~~~~~~~~~~~~      ~~~~~~~~~~~~~~~~~~~~~~~~~~~~~~~~|
|~~~~~~~~~~~~~~~~~~~~~~~~~~~~~~      ~~~~~~~~~~~~~~~~~~~~~~~~~~~~~~~~| 
|~~############  ##############  ##  ##############  ############~~~~|
|~~############  ##############  ##  ##############  ############~~~~|
|~~~~~~~~~~~~~~~~~~~~~~~~~~~~~~      ~~~~~~~~~~~~~~~~~~~~~~~~~~~~~~~~|
|~~~~~~~~~~~~~~~~~~~~~~~~~~~~~~      ~~~~~~~~~~~~~~~~~~~~~~~~~~~~~~~~| 
|~~##~~##~~##~~##~~##~~##~~##~~######~~##~~##~~##~~##~~##~~##~~##~~~~|
|~~##~~##~~##~~##~~##~~##~~##~~######~~##~~##~~##~~##~~##~~##~~##~~~~|
|~~~~~~~~~~~~~~~~~~~~~~~~~~~~~~~~##~~~~~~~~~~~~~~~~~~~~~~~~~~~~~~~~~~|
|~~~~~~~~~~~~~~~~~~~~~~~~~~~~~~~~##~~~~~~~~~~~~~~~~~~~~~~~~~~~~~~~~~~| 
|~~##~~##~~##~~##~~##~~##~~##~~######~~##~~##~~##~~##~~##~~##~~##~~~~|
|~~##~~##~~##~~##~~##~~##~~##~~######~~##~~##~~##~~##~~##~~##~~##~~~~|
|~~~~~~~~~~~~~~~~~~~~~~~~~~~~~~~~##~~~~~~~~~~~~~~~~~~~~~~~~~~~~~~~~~~|
|~~~~~~~~~~~~~~~~~~~~~~~~~~~~~~~~##~~~~~~~~~~~~~~~~~~~~~~~~~~~~~~~~~~| 
|~~##~~##~~##~~##~~##~~##~~##~~######~~##~~##~~##~~##~~##~~##~~##~~~~|
|~~##~~##~~##~~##~~##~~##~~##~~######~~##~~##~~##~~##~~##~~##~~##~~~~|
|~~~~~~~~~~~~~~~~~~~~~~~~~~~~~~~~##~~~~~~~~~~~~~~~~~~~~~~~~~~~~~~~~~~|
|~~~~~~~~~~~~~~~~~~~~~~~~~~~~~~~~##~~~~~~~~~~~~~~~~~~~~~~~~~~~~~~~~~~|
|~~##~~##~~##~~##~~##~~##~~##~~######~~##~~##~~##~~##~~##~~##~~##    |
|~~##~~##~~##~~##~~##~~##~~##~~######~~##~~##~~##~~##~~##~~##~~##    |
|~~~~~~~~~~~~~~~~~~~~~~~~~~~~~~~~~~~~~~~~~~~~~~~~~~~~~~~~~~~~~       |
|~~~~~~~~~~~~~~~~~~~~~~~~~~~~~~~~~~~~~~~~~~~~~~~~~~~~~~~~~~~~~       |
----------------------------------------------------------------------