---------------------------------------
|   ~~~~~~~~~~~~~~~~~~~~~~~~~~~~~~~~~~|
|  ########~~##########~~#########~~~ |
|   ~~~~~~~~~~~~~~~~~~~~~~~~~~~~~~~##~|
| #~~~~~~~~~~~~~~~~~~~~~~~~~~~~~~~~~# |
| #~~~~~~~~#~~~~~~~~#~~~~~~~~#~~~~~~# |
| #~~~~~~~~#~~~~~~~~#~~~~~~~~#~~~~~~# |
| #~~~~~~~~~~~~~~~~~~~~~~~~~~~~~~~~~# |
|~##~~~~~~~~~~~~~~~~~~~~~~~~~~~~~~~##~|
|~~#########~~##########~~#########~~~|
|~~~########~~##########~~########~~~~|
|##~~~~~~~~~~~~~~~~~~~~~~~~~~~~~~~~~##|
|##~~~~~~~~~~~~~~~~~~~~~~~~~~~~~~~~~##|
|##~~~~~~~~#~~~~~~~~#~~~~~~~~#~~~~~~##|
|##~~~~~~~~#~~~~~~~~#~~~~~~~~#~~~~~~##|
|##~~~~~~~~~~~~~~~~~~~~~~~~~~~~~~~~~##|
|~##~~~~~~~~~~~~~~~~~~~~~~~~~~~~~~~##~|
|~~#########~~##########~~#########~~ |
|~~~########~~##########~~########~~~ |
|##~~~~~~~~~~~~~~~~~~~~~~~~~~~~~~~~~##|
|##~~~~~~~~~~~~~~~~~~~~~~~~~~~~~~~~~##|
|##~~~~~~~~#~~~~~~~~#~~~~~~~~#~~~~~~##|
|##~~~~~~~~#~~~~~~~~#~~~~~~~~#~~~~~~##|
|##~~~~~~~~~~~~~~~~~~~~~~~~~~~~~~~~~##|
|~##~~~~~~~~~~~~~~~~~~~~~~~~~~~~~~~##~|
|~~#########~~##########~~#########~~~|
|~~~########~~##########~~########~~~~|
| #~~~~~~~~~~~~~~~~~~~~~~~~~~~~~~~~~# |
| #~~~~~~~~~~~~~~~~~~~~~~~~~~~~~~~~~# |
| #~~~~~~~~#~~~~~~~~#~~~~~~~~#~~~~~~# |
| #~~~~~~~~#~~~~~~~~#~~~~~~~~#~~~~~~# |
| #~~~~~~~~~~~~~~~~~~~~~~~~~~~~~~~~~# |
|~  ~~~~~~~~~~~~~~~~~~~~~~~~~~~~~~~   |
|~~#########~~##########~~#########   |
|~~~########~~##########~~########    |
---------------------------------------