-------------------------------------------------
|      ####~~~~~~~###########~~~~~~####~~~~~~~~~|
|     ~~~~~##~~~~~~~~~~##~~~~~~~~~~##~~~##~~~~~~|
|~~~##~~~~~~##~~~~~~~~~##~~~~~~~~~##~~~$~##~~~~~|
|~~~##~~~~~~##~~~~~~~~~##~~~~~~~~~##~~~~~~~~~~~~|
|~~~##~~~~~~##~~~~~~~~~~~~~~~~~~~~~##~~~~~~~~~~~|
|~~~##~~~~~~##~~~~~~~~~##~~~~~~~~~~~##~~~~~~~~~~|
|~~~~##~~~~~~~~~~~~~~~~##~~~~~~~~~~~~##~~~~~~~~~|
|###########~~~~~~~###########~~~~~~~~~~~~##~~~~|
|~~~~~~~~~~~~~~~~~~~~~~~~~~~~~~~~~~~~~~~~~~~~~~#|
|~~~~~~~~~~~~~~~~~~~~##################        #|
|~~~~~~~~~~~##########~~~~~~~~~~~~~~#######~~~~#|
|~~~~~~~~~~##~~~~~~~~~~~~~~~~~~~~~~##~~~~~~~~~~#|
|~~~~~~~~~##~~~~~~##~~~~~~~~~~~~~~~##~~~~~~~~~~#|
|~~~~~~~~##~~~$~~##~~~~~~~~~~~~~~~~##~~~~~~~~~~#|
|~~~~~~~##~~~~~~##~~~~~~~~~~~~~~~~~##~~~~~~~~~~#|
|~~~~~~##~~~~~~##~~~~~~~$~$~~~~~~~~##~~~~~~~~~~#|
|~~~~~##~~~~~~##~~~~~~~~~$~~~~~~~~~##~~~~~~~~~~#|
|~~~~~~~~~~~~##~~~~~~~~~~~~~~~~~~~~##~~~~~~~~~~#|
|###################################~~~~~~~~~~~#|
|~~~~~~~~#~~~~~~~~~~~~~~~~~~~~~~~~~~~~~~~~~~~~~#|
|~~~~~~~~~~~~~~~~~~~~~~~$~$~~~~~~~~~~~~~~~~~~~~#|
|~~~~##########~~~~~~~~~~$~~~~~~~~~~##~~~~~~~~~#|
|~~~~~~~~~~~##~~~~~~~~~~~~~~~~~~~~~~##~~~~~~~~~#|
|~~##      ##~~~~~~~~~~~~~~~~~~~~~~~##~~~~~~~~~#|
|~~##~~~~~~#####################################|
|~~##~~~~~~~~~~~~~~~~~~~~~~~~~~~~~~~##~~~~~~~~$#|
|~~~##~~~~~~##~~~~~~~~~~~~~~~~~~~~~~##~~~~~~~~~#|
|~~~~##########~~~~~~~~~~~~~~~~~~~~~##~~~~~~~~~#|
|~~~~~~~~~~~~~~~~~~~~~~~~~~~~~~~~~~~~~~~~~~~~~~#|
|~~~~~~~~~~~~~~~~~~~~~~~~~~~~~~~~~~~~~~~~~~~~~~#|
|~~~~~~~~~~~#########################~~~~~~~~~~#|
|~~~~~~~~~~##~~~~~~##~~~~~~~~~~~~~~##~~~~~~~~~~#|
|~~~~~~~~~~~~~~~~~##~~~~~~~~~~~~~~~##~~~~~~~~~~#|
|~~~~~~~~##~~~~~~##~~~~~~~~~~~~~~~~##~~~~~~~~~~#|
|##~##########~~~~~~~~~~~~~~~~~~~~~##~~~~~~~~~~#|
|~~~~~~##~~~~~~##~~~~~~~~~~~~~~~~~~##~~~~~~~~~~#|
|~~~~~##~~~~~~##~~~~~~~~~~~~~~~~~~~##~~~~~~~~~~#|
|~~~~##########~~~~~~~~~~~~~~~~~~~~~########## #|
|~~~~~~~~~~~~~~~~~~~~~~~~~~~~~~~~~~~            |
-------------------------------------------------
