#############################################
#~~~~~~~~~~~#~~~~~~~#~~~~~~~~~#~#~#~#~~~~~~~#
#~#####~###~###########~#####~#~#~#~#~#####~#
#~#~~~#~~~#~~~~~~~~~~~#~~~#~~~#~~~#~~~#~~~#~#
#~#~###~#####~#######~###~#####~#####~###~#~#
#~#~~~#~~~#~~~~~~~#~#~~~#~#~~~#~~~#~~~#~~~#~#
#~#~#####~#~#####~#~###~#~#~#~#~###~###~#~###
#~#~~~~~~~#~#~~~#~#~~~#~#~#~#~#~#~~~#~~~#~~~#
#~#########~###~#~###~#~#~###~#~#####~#####~#
#~#~~~~~~~#~~~#~#~~~~~#~~~#~~~#~~~#~#~#~~~#~#
#~#~#~###~###~#~#######~#####~#####~#~###~#~#
#~#~#~~~#~~~~~#~~~#~~~#~~~~~#~~~~~#~~~#~~~#~#
#~#~###~#####~###~#~#~#######~#######~#####~#
#~#~~~#~#~~~~~#~~~#$#$#$$$$$$$#~~~~~#~~~~~#~#
#~###~#~#####~#####~#~#####~#~#~#~#~###~#~#~#
#~#~~~#~#~~~~~~~#~~~#~~~~~#~#~#~#~#~~~~~#~#~#
#~#~###~#######~###~#####~#~#~#####~#####~#~#
#~#~~~#~~~~~~~~~#~~~~~#~~~#~#~~~~~~~#~~~#~#~#
#~###~#########~#####~#~#~###~#####~###~#~#~#
#~~~#~~~#~#~~~#~~~~~~~#~#~~~#~#~#~~~#~~~#~~~#
###~#~#~#~#~#~###~#####~###~#~#~#~#~###~###~#
#~~~#~#~#~~~#~~~~~#~~~~~#~~~#~~~#~#~#~~~#~~~#
#~###~#~#####~#####~#####~#####~#~#####~#~#~#
#~~~#~~~#~#~~~#~~~~~#~~~~~~~#~~~#~#~#~~~#~#~#
#~###~###~#~###~###~###~#~###~#~###~###~#~#~#
#~#~~~~~~~#~#~~~~~#~~~~~#~~~~~#~~~~~#~#~~~#~#
#~#########~#####################~#~#~#####~#
#~~~~~~~~~#~~~~~~~~~#~~~~~~~~~#~~~#~#~#~~~~~#
#~#######~#########~#~#########~###~#~#~#~#~#
#~~~~~~~#~~~~~~~~~~~#~~~~~~~~~~~#~~~~~#~#~~~#
#############################################
