|---------------------------------------------|
|#                                           #|
|###################~~~#######################|
|##############~~~~~~~~~~~####################|
|##########~~~~~~~~~~~~~~~#########~$~########|
|########~~~####################~~~~~~~~~~~~##|
|######~~~~########~~##########~~~~~~~~~~~~~##|
|####~~~~~~~######~~~~~~######~~~~~~~~~~~~~~##|
|###~~~~~~~~~#####~~~~~~~~~###~~~~~~~~~~~~~~##|
|##~~~~~~~~~~######~~~~~~~~~##~~~~~~~~~~~~~~##|
|#~~~~~~~~~~########~~~~~~~~#~~~~~~~~~~~~~~~##|
|#~~~~~~~~    $$                         $  ##| 
|#~~~~~~~~~##########~~~~~~~ ~~~~~~~~~~~~~~~##|
|##~~~~~~~~~~######~~~~~~~~~##~~~~~~~~~~~~~~##|
|###~~~~~~~~~#####~~~~~~~~~###~~~~~~~~~~~~~~##|
|####~~~~~~~######~~~~~~######~~~~~~~~~~~~~~##|
|######~~~~########~~##########~~~~~~~~~~~~~##|
|########~~~####################~~~~~~~~~~~~##|
|##########~~~~~~~~~~~~~~~#########~$~########|
|##############~~~~~~~~~~~####################|
|###################~~~#######################|
|#                                           #|
|---------------------------------------------|
