----------------------------------------------------------------------
|	   ~~~~~~~~~~~~~~~~~~~~~~~~~~~~~~~~~~~~~~~~~~~~~~~~~~~~~~~~~~~~~~|
|  	   ~~~~~~~~~~~~~~~~~~~~~~~~~~~~~~~~~~~~~~~~~~~~~~~~~~~~~~~~~~~~~~|
|  ##~~##~~##~~##~~##~~##~~##~~##~~##~~##~~##~~##~~##~~##~~##~~##~~~~|
|  ##~~##~~##~~##~~##~~##~~##~~##~~##~~##~~##~~##~~##~~##~~##~~##~~~~|
|~~~~~~~~~~~~~~~~~~~~~~~~~~~~~~~~~~~~~~~~~~~~~~~~~~~~~~~~~~~~~~~~~~~~|
|~~~~~~~~~~~~~~~~~~~~~~~~~~~~~~~~~~~~~~~~~~~~~~~~~~~~~~~~~~~~~~~~~~~~| 
|~~##~~##~~##~~##~~##~~##~~##~~##~~##~~##~~##~~##~~##~~##~~##~~##~~~~|
|~~##~~##~~##~~##~~##~~##~~##~~##~~##~~##~~##~~##~~##~~##~~##~~##~~~~|
|~~~~~~~~~~~~~~~~~~~~~~~~~~~~~~~~~~~~~~~~~~~~~~~~~~~~~~~~~~~~~~~~~~~~|
|~~~~~~~~~~~~~~~~~~~~~~~~~~~~~~~~~~~~~~~~~~~~~~~~~~~~~~~~~~~~~~~~~~~~| 
|~~##~~##~~##~~##~~##~~##~~##~~##~~##~~##~~##~~##~~##~~##~~##~~##~~~~|
|~~##~~##~~##~~##~~##~~##~~##~~##~~##~~##~~##~~##~~##~~##~~##~~##~~~~|
|~~~~~~~~~~~~~~~~~~~~~~~~~~~~~~~~~~~~~~~~~~~~~~~~~~~~~~~~~~~~~~~~~~~~|
|~~~~~~~~~~~~~~~~~~~~~~~~~~~~~~~~~~~~~~~~~~~~~~~~~~~~~~~~~~~~~~~~~~~~| 
|~~##~~##~~##~~##~~##~~##~~##~~##~~##~~##~~##~~##~~##~~##~~##~~##~~~~|
|~~##~~##~~##~~##~~##~~##~~##~~##~~##~~##~~##~~##~~##~~##~~##~~##~~~~|
|~~~~~~~~~~~~~~~~~~~~~~~~~~~~~~~~~~~~~~~~~~~~~~~~~~~~~~~~~~~~~~~~~~~~|
|~~~~~~~~~~~~~~~~~~~~~~~~~~~~~~~~~~~~~~~~~~~~~~~~~~~~~~~~~~~~~~~~~~~~| 
|~~##~~##~~##~~##~~##~~##~~##~~##~~##~~##~~##~~##~~##~~##~~##~~##~~~~|
|~~##~~##~~##~~##~~##~~##~~##~~##~~##~~##~~##~~##~~##~~##~~##~~##~~~~|
|~~~~~~~~~~~~~~~~~~~~~~~~~~~~~~~~~~~~~~~~~~~~~~~~~~~~~~~~~~~~~~~~~~~~|
|~~~~~~~~~~~~~~~~~~~~~~~~~~~~~~~~~~~~~~~~~~~~~~~~~~~~~~~~~~~~~~~~~~~~| 
|~~##~~##~~##~~##~~##~~##~~##~~##~~##~~##~~##~~##~~##~~##~~##~~##~~~~|
|~~##~~##~~##~~##~~##~~##~~##~~##~~##~~##~~##~~##~~##~~##~~##~~##~~~~|
|~~~~~~~~~~~~~~~~~~~~~~~~~~~~~~~~~~~~~~~~~~~~~~~~~~~~~~~~~~~~~~~~~~~~|
|~~~~~~~~~~~~~~~~~~~~~~~~~~~~~~~~~~~~~~~~~~~~~~~~~~~~~~~~~~~~~~~~~~~~| 
|~~##~~##~~##~~##~~##~~##~~##~~##~~##~~##~~##~~##~~##~~##~~##~~##~~~~|
|~~##~~##~~##~~##~~##~~##~~##~~##~~##~~##~~##~~##~~##~~##~~##~~##~~~~|
|~~~~~~~~~~~~~~~~~~~~~~~~~~~~~~~~~~~~~~~~~~~~~~~~~~~~~~~~~~~~~~~~~~~~|
|~~~~~~~~~~~~~~~~~~~~~~~~~~~~~~~~~~~~~~~~~~~~~~~~~~~~~~~~~~~~~~~~~~~~| 
|~~##~~##~~##~~##~~##~~##~~##~~##~~##~~##~~##~~##~~##~~##~~##~~##~~~~|
|~~##~~##~~##~~##~~##~~##~~##~~##~~##~~##~~##~~##~~##~~##~~##~~##~~~~|
|~~~~~~~~~~~~~~~~~~~~~~~~~~~~~~~~~~~~~~~~~~~~~~~~~~~~~~~~~~~~~~~~~~~~|
|~~~~~~~~~~~~~~~~~~~~~~~~~~~~~~~~~~~~~~~~~~~~~~~~~~~~~~~~~~~~~~~~~~~~|
|~~##~~##~~##~~##~~##~~##~~##~~##~~##~~##~~##~~##~~##~~##~~##~~##    |
|~~##~~##~~##~~##~~##~~##~~##~~##~~##~~##~~##~~##~~##~~##~~##~~##    |
|~~~~~~~~~~~~~~~~~~~~~~~~~~~~~~~~~~~~~~~~~~~~~~~~~~~~~~~~~~~~~       |
|~~~~~~~~~~~~~~~~~~~~~~~~~~~~~~~~~~~~~~~~~~~~~~~~~~~~~~~~~~~~~       |
----------------------------------------------------------------------